0000000000000000000000000000000000000000000000000000000000000000
0000000000000000000000000000000000000000000000000000000000000000
0000000000000000000000000000000000000000000000000000000000000000
0000000000000000000000000000000000000000000000000000000000000000
0000000000000000000000000022220000000000000000000000000000000000
0000000000000000000000000000000000000000000000000000000000000000
0000000000000000000000000000000000000000000000002200000000000000
0220000000000000022200000000000000002220000000000000000000000220
0000000000000000000000000000000000000000000000000000000000000000
0000002200000000000000002222000000000000000000002200000000000000
0000000000000000000000000000000000000000000000000000000000000000
0000000000000222000000000000000000000022200000000000002220000000
0000000000000000000000000000000000000000000000000000000000000000
0220000022000000000022000000002200000000000022000000002200000220
0000000000000000000000000000000000000000000000000000000000000000
0000000000000000022222222222222222222222222200000000000000000000
0000000000000000000000000000000000000000000000000000000000000000
2222222222200000000000000000000000000000000000000000022222222222
1111111111100000000000000000000000000000000000000000011111111111
1111111111100000000000000000000000000000000000000000011111111111
1111111111100000000000000000000000000000000000000000011111111111
1111111111122222222222222222222222222222222222222222211111111111
1111111111111111111111111111111111111111111111111111111111111111
1111111111111111111111111111111111111111111111111111111111111111
1111111111111111111111111111111111111111111111111111111111111111